 # # # # # # # # # # # #
 # . . . . . . . . . . #
 # . # . # . # # # # . #
 # # # . # . . . . # . #
 # . . . . # # # . # . #
 # # # # . # F . . # . .
 # # # # # # # # # # # #
